dates,counts_1,counts_2,counts_3,counts_4,counts_5
1,4,6,4,2,16
2,6,2,4,4,16
3,2,3,5,8,18
4,1,1,0,2,4
5,2,3,3,2,10
6,1,0,1,0,2
7,2,1,6,3,12
8,3,1,1,1,6
9,1,1,2,0,4
10,2,2,3,3,10
11,4,1,2,2,9
12,1,1,2,4,8
13,4,0,1,1,6
14,3,1,1,1,6
15,2,1,3,2,8
16,1,1,0,0,2
17,1,1,2,0,4
18,1,1,0,0,2
19,3,0,1,0,4
20,2,0,1,1,4
21,4,1,0,1,6
22,0,1,0,1,2
23,0,2,0,0,2
24,0,0,1,1,2
25,0,0,0,0,0
26,2,0,0,0,2
27,1,1,0,0,2
28,2,1,1,0,4
